AAAAAAAAAAAAAAAAAAAAAAAAAAAAAAAAAAAAAAAAAAAAAAAAAAAAAAAAAAAAAAAAAAAAAAAAAAAAAAAAAAAAAAAAAAAAAAAAAAAAAAAAAAAAAAAAAAAAAAAAA
ATTTTTTTTTTTTTTTTTTTTTTTTTTTTTT.E.TTTTTTTTTTTTTTTTTTTTTTTTTTTTTTTTT99999999999999999999999999999999999999999999999999999A
ATTTTTTTTTTTTTTTT9TTTTTTTTTTTT.....TTTTTTTTTTTTTTTTTTTTTTTTTTTTTTTT....................................................9A
ATTTTTTTTTTTTTTTTTTTTTTTTTTT...TTT...TTTTTTTTTTTTTTTTTTTTTTTTTTTTTT.....WWWWWWWWWWWWWWWWW....................99999999999A
ATTTTTTTTTTTTTTTTTTTTTTTTTT...........TTTTTTTTTTTTTTTTTTTTTTTTTT.......................................................9A
ATTTTTTTTTTTTTTTTTTTTTTTTT.............TTTTTTTTTTTTTTTTTTTTTTTTT.............................................99999999999A
ATTTTTTTTTTTTTTTTTTTTTTTTT..............................................WWWWWWWWWWWWWWWWW..............................9A
A00RRR00RRR00RRR00RRR00RRR...................................................................................99999999999A
A00RR0RRRRR00RRR00RRR00RRR.............9999999..99.9...................................................................9A
A000RRR0RRR00RRR00RRR00RR0..............................................WWWWWWWWWWWWWWWWW....................99999999999A
AH.....................................................................................................................9A
A00R0RRR0RR00RRR00RRR00RR...............................................WWWWWWWWWWWWWWWWW....................99999999999A
A00RR0RRRRR00RRR00RRR00RRR.............................................................................................9A
A00RRRRR0RR00RRR00RRR00RRR......................9999......99.................................................99999999999A
A66666RR6666666RR666666................................................................................................9A
A66RR6666666666666...............................................................B...........................99999999999A
A66666666666R666.................................................................FP....................................9A
A66666R66R6666.........................................................................................................9A
A6666666666666...............999999999999..................999999.9.9.9...99.................................99999999999A
A6666666666666.........................................................................................................9A
A6666666666666..............................................................................................M99999999999A
A6666666666666....66..................................G......................................999999.....................A
A66666666666....6666..................................9999..............................................................A
A66666666666..666666........................,...........................................999999......99.....999999.......A
A66666666666..666666....................................................................................................A
A........66..6666666............9999999.................................................................................A
AU.......66..6666666.........................................999999.....................................................A
A66666..666..6666666................................................................99999999999.........................A
A6666.....6..6666666....................................................................................................A
A6666666.....6666666....................................................................................................A
A6666666666666666666..........................99999...........................................99999999..................A
A6666666666666666666....................................................................................................A
A6666666666666666666....................................................................................................A
ASSSSSSSSSSSSSSSSSSSSSSSSSSS..........................................................9..99999..........................A
ASSSSSSSSSSSSSSSSSSSSSSSSSSSSSS..................................99999..................................................A
ASSSS...................................................................................................................A
ASSS.......................................................................................................99999........A
ASSS....SSSSSSSSSSSSSSSSSSSSSSSS........999.....9....9.999999...........................................................A
ASSS...SSSSSSSSSSSSSSSSSSSSSSSSS.............................................9999999.999................8888888888888888A
ASSS...SSSSSSSSSSSSSSSSSSSSSSSSS99999...................................................................8888888888888888A
ASSS...SSSSSSSSSSSSSSSSSSSSSSSSSSSSSSSSSSSSSSSSSSSSSSSSSSSSSSSSSSSSSSSSSSSSSS8888888888888888888888888..8888888888888888A
ASSS...SSSSSSSSSSSSSSSSSSSSSSSSSSSSSSSSSSSSSSSSSSSSSSSSSSSSSSSSSSSSSSSSSSSSSS8888888888888888888888888..8888888888888888A
ASSS...SSSSSSSSSSSSSSSSSSSSSSSSSSSSSSSSSSSSSSSSSSSSSSSSSSSSSSSSSSSSSSSSSSSSSS88888888888888888888888888....8888888888888A
ASSS...SSSSSSSSSSSSSSSSSSSSSSSSSSSSSSSSSSSSSSSSSSSSSSSSSSSSSSSSSSSSSSSSSSSSSS88888888888888888888888888888....8888888888A
ASSS...SSSSSSSSSSSSSSSSSSSSSSSSSSSSSSSSSSSSSSSSSSSSSSSSSSSSSSSSSSSSSSSSSSSSSS88888888888888888888888.......8888888888888A
ASSSS..SSSSSSSSSSSSSSSSSSSSSSSSSSSSSSSSSSSSSSSSSSSSSSSSSSSSSSSSSSSSSS88888888888888888888888888888...8888888888888888888A
ASSSS..SSSSSSSSSSSSSSSSSSSSSSSSSSSSSSSSSSSSSSSSSSSSSSSSSSSSSSSSSSSSSS8888888888888888888888888888..88888888...8888888888A
ASSSS.SSSSSSSSSSSSSSSSSSSSSSSSSSSSSSSSSSSSSSSSSSSSSSSSSSSSSSSSSSSS8888888888888888888888888888888..8....88..8.....888888A
ASSSS.SSSSSSSSSSSSSSSSSSSSSSSSSSSSSSSSSSSSSSSSSSSSSSSSSSSSSSSSSSSSSSSSSSSSSSS888888888888888888888...8...8..88888...8..4A
ASSSS3SSSSSSSSSSSSSSSSSSSSSSSSSSSSSSSSSSSSSSSSSSSSSSSSSSSSSSSSSSSSSSSSSSSSS8888888888888888888888888888.....8888888....8A
AAAAAAAAAAAAAAAAAAAAAAAAAAAAAAAAAAAAAAAAAAAAAAAAAAAAAAAAAAAAAAAAAAAAAAAAAAAAAAAAAAAAAAAAAAAAAAAAAAAAAAAAAAAAAAAAAAAAAAAAA